WWWWWWW
W     W
W W W W
W W W W
WSW W W
W W W W
WWWWW W
