WWWWWWWWWWWWWWWWWWWW
W WWW    WWWW     WW
W WWWWWW      WWW WW
W   WWWWWWWWW WWW   
WWWWWW     WW WWW WW
WWWWWW WWWWWW WWW  W
W      WWWWWW    W W
W WWWWWW   WW WW W W
W    WWW W    WW WWW
WWWW     WWWW     WW
WWWW WWWWWWWWW WW  W
WW   WWWW      WWWWW
WW WWWWWWWWWWWWWWSWW
WW      WWW   WWW WW
WWWWW       W     WW
WWWWWWWWWWWWWWWWWWWW
