WW WWWWWWW
WW WWW WWW
WW     WWW
WWWWWW WWW
WW WWW  WW
W SWWWW  W
WW W  WW W
WW   W W W
WWWW W W W
W WW W   W
W    WWW W
WWWW  WW W
WWWWW    W
WWWWWWWWWW
