WWWWWWWWWWWWWWWWW
WWW     WWWW   WW
W   WWW W    WWWW
WWWW      WWWWWWW
WWWW WWWW  WWWWWW
  WW   WWW    WWW
W WWWW  WWWWW WWW
W          WW  WW
WWWWWWWWWWWWWWWWW
