WWWW WWWWWW
WWWW     WW
WWWWWWWW WW
W        WW
W WWWWWWWWW
W W      WW
W   WWWW WW
WWWWW    WW
WWW   S WWW
WWW W   WWW
WWW  WW   W
WWWW   WW W
WW  WWW   W
WWW     WWW
WWWWWWWWWWW
