WWWWWWWWWWWWWWWWWWWWWWWWW
WWWWWWWWW        WWWWWWWW
WWWW       WWWWWW    WWWW
WW    WWWWWWWWWWWWWW   WW
W   WWWWWWWWWWWWWWWWW  WW
WW                 S  WWW
WWWWWWWWWWWWWWWWWWWWWWWWW
WWWW WWWWWWWW WWWWW WWWWW
WWWWWWWWW WWWWWWWWWWWWWWW
WWWWWWWWWWWWWWWWWWWWWWWWW
