WWWWWWWWWWWWWWWWWWWWW
WWWW     WWWWWWWWWWWW
WW         WWWWWWWWWw
WWW WW WW WWWWWWWW   
WWWWWWWWWWWWWWWWWWW W
WWWWWWWWW   WWWWWWWWW
WWWWWWWWWW WWWWWWWWWW
WWWWWWWWWW WWWWWWWWWW
WWWWWWW       WWWWWWW
WWWWWW         WWWWWW
WWWWW   W   W   WWWWW
WWWWW           WWWWW
WWWWWW  WWWWW  WWWWWW
WWWWWW  WWWWW  WWWWWW
WWWW             WWWW
W         S         W
WWWWWWWWWWWWWWWWWWWWW
