WWWWWWWWWWWWWWWWWW   WWWW
W       W W   W       W W
W WWWWW W W WWW W W WWW W
W W   W   W     W W W   W
W W W WWW WWW W W W W WWW
W W W W W     W W W   W W
W W W W WWWWWWW W WWWWW W
W   W W         W W     W
WWWWWWWWWWW WWWWW W WWW W
W     W   W W     W   W W
W WWWWW W W W WWWWWWWWW W
W     W W WSW           W
W W W W W WWWWWWWWWWWWW W
W W W   W         W     W
W W W W WWW W WWWWWWW WWW
W W W W W   W W     W   W
W WWWWWWW WWW W WWW WWW W
W W     W W     W W   W W
WWW WWW W W WWWWW WWW W W
W   W     W   W     W W W
W WWWWW W WWW W W W W W W
W     W W   W W W WWW   W
W WWW WWWWWWW W W W W W W
    W           W   W W W
   WWWWWWWWWWWWWWWWWWWWWW
